... ...............
.##....##..........
.#......#..........
.#......#..........
.#......#..........
.#......#..........
.#......#..........
.#......#..........
.########..........
...................
