... ..........
.##....##.....
.#......#.....
.#......#.....
.#......#.....
.#......#.....
.#......#.....
.#......#.....
.########.....
..............
